1111111
1100011
1EC10P1
1111111