111111111111111111111
10011000C000000010111
111110100000111011111
10PC10100000000011111
100001010111000000001
101100100000000000001
1E0100000000000000001
111111111111111111111