111111111111111111111
10P0100000000C0011111
111010100000111011111
1000101000C0000011111
100010101110000011111
100000100000000C0E0N1
111111111111111111111