1111111111111111111111111111111111111
100P000000000000000000C00111110000001
1110111111111011111010111111111110111
1000000000001010000010100000010000111
1110111111111111111111111111111111111
100C000000000000C000000000000C00NN001
1111011111111111111110111111111111011
101001000000100NN00010100000000000011
1010111111111010111010111111101111111
1000100000001010000010100000000000111
1110111111111011111110111111101111111
1000000000C00010000000000000000000001
1111011111111111011111111111111111111
1000010000001000000010100000C00000001
10111111111110111011100C1111111111111
1010000000NN101000001010000000E111111
1000100CCC00001000000010000000000CCC1
1111111111111111111111111111111111111